%%%%%%%%%%%%%%%%%%%%%%%%%%%%%%%%%%%%%
%                                  P%
% %%%%%%%   %%%   %%% %%% %%%%%%%   %
%                                   %
%%%%% %%%%% %%%       %%% %%%%%   %%%
%                                   %
% %%%       %%% %%%%% %%%   %%% %%% %
%                                   %
%%% %%%%%%%%% %%%%%%% %%% %%%       %
%                                   %
%   %%%%%   %%%     %%%   %%% %%%   %
%                                   %
%     %%%%%%%   %%%%%%%%% %%%   %%% %
%                                   %
%%% %%%   %%%%% %%%%% %%% %%% %%%%% %
%                                   %
%         %%% %%% %%% %%%           %
%                                   %
%%% %%%%%%%     %%%%% %%%   %%% %%%%%
%                                   %
%%%%%     %%%%%%%%% %%%%%%%%%%%   %%%
%                                   %
% %%% %%%%% %%%%%%%%% %%%%%     %%% %
%                                   %
%     %%%%% %%%         %%%%%%%%%%%%%
%                                   %
%   %%% %%%       %%%%%%%%% %%%     %
%                                   %
% %%% %%% %%%%% %%%     %%%%%   %%%%%
%                                   %
%%%   %%%%% %%%%% %%% %%%   %%%   %%%
%                                   %
%   %%%         %%%%%%%%%           %
%+                                  %
%++     %%% %%% %%%%%%% %%% %%% %%% %
%.%                                 %
%%%%%%%%%%%%%%%%%%%%%%%%%%%%%%%%%%%%%
